1  2  3  4  5  6  7  8  
17  *  *  *  *  *  *  24  
33  *  *  *  *  *  *  40  
49  *  *  *  *  *  *  56  
57  *  *  *  *  *  *  64  
41  *  *  *  *  *  *  48  
25  *  *  *  *  *  *  32  
9  10  11  12  13  14  15  16  
